"#" "#" "#" "#" "#" "#" "#" "#" "#" "#" "#" "#" "#" "#" "#" "#" "#"
"#" "T" "." "." "." "." "." "." "." "." "." "#" "." "#" "." "." "#"
"#" "#" "#" "#" "#" "#" "#" "#" "#" "." "." "." "." "#" "." "#" "#"
"#" "." "." "." "." '.' '.' '.' '.' '.' '#' '.' '.' '.' '.' '.' '#'
'#' '.' '#' '#' '#' '.' '#' '.' '#' '.' '#' '.' '#' '.' '#' '.' '#'
'#' '.' '#' '.' '#' '.' '#' '.' '#' '.' '#' '.' '#' '.' '#' '.' '#'
'#' '.' '#' '.' '#' '.' '#' '.' '#' '.' '.' '#' '#' '.' '#' '#' '#'
'#' '.' '#' '.' '.' '.' '#' '.' '#' '#' '.' '#' '.' '.' '.' '.' '#'
'#' '#' '.' '.' '#' '#' '#' '.' '.' '#' '.' '#' '.' '.' '#' '#' '#'
'#' '.' '.' '#' '.' '.' '.' '.' '#' '#' '.' '#' '#' '.' '.' '.' '#'
'#' '#' '#' '#' '.' '#' '.' '.' '.' '#' '.' '#' '.' '.' '#' '#' '#'
'#' '.' '.' '.' '.' '#' '.' '#' '.' '#' '.' '#' '#' '.' '#' '.' '#'
'#' '.' '#' '#' '.' '#' '.' '#' '.' '#' '.' '.' '#' '.' '.' '.' '#'
'#' '#' '#' '#' '#' '#' '#' '#' '#' '#' '#' '#' '#' '#' '#' 'S' '#'